                                                                                                                                             *                                                 
                                                                                                                                             *                                                 
                                                                                                                                       ***************                                         
                                                                                                                                       *     *       *                                         
                                                                                                                                       *     *       *                                         
                                                                                                                      *                *             *                                         
                                                                                                               **********              *             *                                         
                                                                                                                      ******************             *                                         
                                                                                                                        *******          ***************                                       
                                                                                                                        *     *          *   *       * *                                       
                                                                                                                              *          * ***       ***                                       
                                                                                                                              *    ********* ***********                                       
                                                                                                                         ***********************    * **                                       
                                                                                                                              **** * ***********    * **                                       
                                                                                                                                   * ******  *********************************      *          
                                                                                                                          ********** ******  ****   ***********    * *     * *   **********    
                                                                                                                    ************************************      *    * *     * *   * **          
                                                                                                                          * ***************  **               ****** *     * *   * **         *
                                                                                                                          *  * ************  *                       *   *************        *
                                                                                                                   ***************************                    ********** ******************
                                                                                                                        *    **************  *                     *********************      *
                                                                                                                        *    ** ***********  *                     * *   **  * *   *          *
                                                                                                                        * ******************            *          * *   **  ******************
                                                                                                                        * *  *********** *              *          *******************         
                                                                                                                   *    * *  **************             *  *       * ********* *     *         
                                                                                                                   ***  ************************        *  *   *     ********* *               
                                                                                                                   * *********************     *    ************             * *               
                                                                                                                   ***********************     *    * * *  *   *************** *               
 *****************                                                                                           ******* ********* * *  ****************************       *********               
 *               *                                                                                           **    * * **********************  **********  *   *   *** *                       
 *               *                                                                                           ***** * * ***  ** ***  *****   *  *      ***  *   *   * * *                       
 ************    *                                                                                            *  * *   ***  ********************************** *   * * *                       
  *    *    *    *                                                                                            *  * *****************************      **************** *                       
  ******    *    *                                                                                    ********************  *********************     **************** *                       
            *    **********                                                                                   *    *   *****************************  *  *   *    ************                 
     ********   *      *                                                                                      *    **************************** *     *  *   *    ***  **    *                 
     *          *      *                                                          *          *************    *   ***** ******* **** ** ** *  * *  *******   *    ***  ********                
     *          *      *                       *                                  *          *           *    *   *   * * *********  ***************  * *****************    **                
     *          *   ***********              * *  **                     *        *          *           ************************************************    ************   ***                
     *********  *   ** *      *              *******                     *********************                        * ******************    *    *    *     *    *   **   **                 
*    * * ****************     *         *    * *   *                     *       ****       **      *********         * * *  * ********************************    *    *   *                  
*      *   *****************  *         ***  * *************             *   ************************** *********         *  ****** **********     ***  ************    *   *                  
*      *   *    ***************         * *  * * ***********         ************* **********  *    * * *  *******        *  ***********           ***       ** *  *    *   *                  
********   *    *   *                   ***  * *                         *  **     *           ******** *  *    **************    *                ***       *  *  ******   *                  
     *     *    ***********           ***************                       *******************************************  **********                 **  ******  *  **       *                  
     *     *    *         *********     *    ********                       ********                       *     * *      * **   **             *****************************                  
     ************************************************                       *                              *     * *        ************        **      *   ***** * *                          
    ********************* **      *     *        ****                       *                              *    ************************        *********************                          
    *        * *   *    * *********                 ***************************                            *    * **********************         *      ***********                            
    *******  * *   *    * *                                                                                *    * **********************************     *****    ***                          
    *******  * *   ******                                                                                  ****** *        *  ******* ****       * *     *        * *                          
       *************                                                                                            * *        *  **   ** ** *       **************   * *           *              
       *     *     *                                                                                                       *  *    ****************************** * *           *              
             *     *                                                                                                       *  *********  *        **    ****************        *              
                                                                                                                                   ** *  *              *     *******************              
                                                                                                                                   *  *********         *       ***********     *              
                                                                                                                                              *         *          *****        *              
                                                                                                                                           ****    ********        ************ *              
                                                                                                                                           *********               *   **********              
                                                                                                                                                                   *******    *                
                                                                                                                                                                         *    *                
                                                                                                                                                                         ******                
