                       *****                             
                       *   *                             
                       *   *                             
                       *   *                             
           ******************                            
                       *                                 
                       *                                 
                       *                  *              
                       *                  *              
                       *                  *              
                      *********************              
                                          *              
                                          *              
                                         *******         
                                               *         
                                               *         
                                               **********
                                                 *       
                                                 *       
                                                 *       
                                                 *       
                             ***********         *       
                             *         *   *     *       
                             *         *   *     *       
                             *         *   * *****       
                             *************** *           
                                       *   * *           
            *******************        *   *********     
                      *       *        *                 
                      *       **********                 
                      *                                  
                  ******                                 
                  *   ******                             
                  *    *   *                             
             ********* * * *                             
****************************                             
*            * *  ** * **************                    
*      *******************  *       *                    
********     * *   ********************                  
       *     * **************       *                    
             *       *              *                    
             *********                                   
             *       *                                   
             *       *                                   
             *       *                                   
                     *                                   
                     *                                   
                     *                                   
                     *                                   
                     *                                   
